NO textures/bansky.xpm
SO textures/flowerwall.xpm
WE textures/wall.xpm
EA textures/wall42.xpm

F    56 , 5, 5
C    89, 64, 78

11111
100N1
11111